R 1920 600
NO pics/ahegao_xpm/3893522.xpm
SO pics/ahegao_xpm/581739463571661590445879.xpm
WE pics/ahegao_xpm/b7747c4222f9ed7ebb5997d80570aef1.xpm
EA pics/ahegao_xpm/unnamed.xpm
S pics/pillar.xpm


111111111111111111111111111
100000000000000000000000001
100000E00000000000202020001
100000000000000000000000001
100000000000000000202020001
111111111001000000000000001
100000000001000000202020001
100000000001000000000000001
111111111111000000000000001
100011110000000000000000001
101011000011000000000000001
101000001111000000000000001
111111111111111111111111111