111111111111111111111111111
100000000000000000000000001
100000000000000000101010001
100000000000000000000000001
100000000000000000101010001
111111111001000000000000001
100000000001000000101010001
100000000001000000000000001
111111111111000000000000001
100011110000000000000000001
101011000011000000000000001
101000001111000000000000001
111111111111111111111111111
	