R 1920 1080
NO ./path_to_the_north_texture
SO ./path_to_the_south_texture
WE ./path_to_the_west_texture
EA ./path_to_the_east_texture
S ./path_to_the_sprite_texture
F 220,100,0
C 225,30,0



111111111111111111111111111
100000000000000000000000001
100000000000000000101010001
100000000000000000000000001
10000000000000000010101000111111111111111111
111111111001000000000000000000000000000000011
100000000001000000101010001111111111111110001
100000000001000000000000001              1101
111111111111000000000000001               111
100011110000000000000000001
101011000011000000000000001               111
101000001111000000000000001              1101
111111111111000000000000001111111111111111001
100000000000000000000000000000000000000000011
10000000000000000000000000111111111111111111
100000000000000000000000001
100000000000000000N00000001
100000000000000000000000001
111111111111111111111111111
