R 1920 1080
NO pics/вулканы.xpm
SO pics/вулк.xpm
WE pics/вулка.xpm
EA pics/вулкан.xpm
S pics/volcano.xpm
F 220,100,0
C 225,30,0

                    111
                   11011
                  1100011
                 110000011
                11000000011
               1100000000011
              110000000000011
 11111111111111000000000000011111111111111
  110000000002000000002000000000000000011
   1110000000000002000000000020000000111
     111000000000000000000000000000111
       111000020000000N0020000000111
         1110000000000000000000111
           111000000000000000111
            1100000002000000011
            1100000000000000011
            1000000000000000001
           110002000111000020011
           1000000111 1110000001
          110000111     111000011
          1000111         1110001
         110111             111011
         1111                 1111