R 1920 1080
NO ./path_to_the_north_texture
SO ./path_to_the_south_texture
WE ./path_to_the_west_texture
EA ./path_to_the_east_texture
S ./path_to_the_sprite_texture
F 220,100,0
C 225,30,0

                   111
                  11011
                 1100011
                110000011
               11000000011
              1100000000011
             110000000000011
 11111111111111000000000000011111111111111
  110000000000000000000000000000000000011
   1110000000000000000000000000000000111
     111000000000000000000000000000111
       111000000000000N0000000000111
         1110000000000000000000111
           111000000000000000111
            1100000000000000011
            1100000000000000011
            1000000000000000001
           110000000111000000011
           1000000111 1110000001
          110000111     111000011
          1000111         1110001
         110111             111011
         1111                 1111
