R 1920 1080
NO pics/6.xpm
SO pics/6.xpm
EA pics/6.xpm
WE pics/6.xpm
S pics/pillar.txt
C 255,200,160
F 122,45,122

11111111111111111
10000000000000001
10201000200000201
10000000000000001
10001000100010001
10000000000000001
1020101000N020201
10000000000000001
10002000200200001
10000000000000001
10200000200002001
10000000000000001
11111111211111111