R 1920 000000000000000000000000000000000000000000000000000000000
NO pics/вулканы.xpm
SO pics/вулк.xpm
WE pics/вулка.xpm
EA pics/вулкан.xpm
S pics/volcano.xpm
F 220,100,110
C 225,30,0

111111111111111111111111111
100000000000000000000000001
100000N00000000000202020001
100000000000000000000000001
100000000000000000202020001
111111111001000000000000001
100000000001000000202020001
100000000001000000000000001
111111111111000000000000001
100011110000000000000000001
101011000011000000000000001
101000001111000000000000001
111111111111111111111111111